111111111
10C100001
1001000C1
100000001
100100001
1EP100001
111111111